10 10
S........@
.#########
.........@
.#########
.........@
.#########
.........@
.#########
.........@
G#########
