100 100
.#......#..##..#..............###.......#..#.....................#..##........#..#.....#......#..###
##....#.....##.#...##...#.#....#.......#.............#..#.#..........#......##........#............#
.......#.......#........#.....#..#..#.......#......#..#.........#...##..##............#.............
........#.....##...............#.##.#.....##.......#...#...#...#.#.@.#.........#.#..##..........#...
..#...#..#......#..##..#........#...#..#..#.....#....#....#......#.....#......#.##...##.#...##...#.#
.....#..#.......#.....#...#.##...#...#.....#.##.......#...#.......#....#.#......#...#..#...#.#......
...##..##....................#......#....#..#........#...#....#...#.#.#........................#....
.........#..##.....###...#......##.....#.#...#.#....#..#...........#........#...............#..#.#..
..#.........#..#.#..##.......#....#....#..#...#.....#....#...#............#......###..#.........#...
#....@..###..##....#.#.................#..#....##................#......#.#..##....#....#...........
..............#...#....#........#..............#..#...##...............##.#.........#..........##..#
..###...#..#.......#....#.....###......##...##......#..##.##....#...#........#.............#.#..#...
..........#..#.#...#..#..#..#..#.....#........#.....#........#...........#.#......##...............#
..#.#...#...........#.##.....#........#.#.......#........#..........#.###...#.......#..#.#...#......
###................#..........#.........#.#......#.#......#.....#..#........#.#.#...##..............
..##.....##.#...........#....###.#..........#......#.#.#.#..###..##....#..............###.##........
.####...........#..#.......##....#.....#......#...#...#..#.........#..#.............#.....#.#.#...#.
.....#.##.......#.#............#..##.....#............#................#...#......#.....#.....#..#..
...................#.........#.....#....................#...#..#..#.....#...........##......#...#...
....#.............#.#..#..##..#.......##...............#.....#....#.#..#.#.....#..#..#....#......#..
...#..##......##.....#...#.#...........##...##..#..........#..##......#...#....#.#.......#....#...#.
.#.......##...#...#...#.............#..#.....#..#..#.........#..#.....#.......#..#.............#..##
#.....#......#...#.................#.#......##..#......#.#..##......#....#...#.......#....##.#....#.
.......#......###..#.....###.....##......##......#..#.....#.#......##...........#............##.....
##.....#.#.#.....#......##.......#...#....#...#..............##...........##...#.....#........#..#..
.......#..#..#............#..##.....##..#..#...#................#.........#.........#...........#..#
.......#........##..##...##.#.##.......#..#.......#.#.##.....#.......#.........##..#......#.........
#.#...................#.....##.#.#....#...#.#.....#...#.#...#....#....#.....#.....#...###..#....#...
.##........#...........###.......................##..##....#.........#.#.#.#......#...#.#.........#.
.........#...#......###.#........##...............##....#........#.##......#...#..........#......##.
.#..#....#.#.....#...#......##...#.##........#.#.#...#.#....#......#....#......#........#..#........
..#....#.......####.#..#.............#........@...###...##..##.....#.......#.#.......#..##.....##...
.........#..#.......#.#.....#........#............#.................#..........#........#........#..
....##..#...#......#..........##.##..#...#..##...#...#....##....#.##...#.##.#..#.#.#..#......#.#.##.
...#...#....##.............##...###......#..##......#.........###..##...#..##........#....#.......#.
##.....#.....#.....#..........#..#....#.....#.............#............#.#.......#.........#.....###
.#....#..###....#...##......#......#............#.#...##............#.##.........###.#..............
.#.....#.........#..#.#........#...#....#.......................#.....##.....#..##....#.......#.....
##....#....#..#......#....#.........##....#........#.#....#.##....#..#...#..........#..#........#...
......#......#.#..#...........#............#.......#..#....#.....................##.##...........##.
..#......#.......#........#..##.#.##..#.#...............#.#.#....#..#........##......#.#..##...#....
...#.............#..#.#..###....#..#...............#.......#..#........#................#...........
........#........##...##.....#..#........##................#.##....#.......#.....#.....#...#.#......
..#.....#.#.#......#.........#..###........#..#..#.....#...........................#.##.#.......#.#.
.#........#...#............##.#......#.............#...................#...............#.##.....###.
................#...#..##..#......#.........#............#....................#....#..#.#.........#.
##...#..#..#......#..#.#.#...........#..#.##........##.##.#................#.#...................#..
#....#...##..##.......##...#.....#....#....##.........#...##.......#..#.....##.......##.#...........
.............#.#.##.#..#..#.#.....##..#.#.....##...........#...#.#......#......#....#............#..
#....#.....#...#.....##........##.#.......#...#...#....#..............##.#..#............#..#.......
.#.##............#......###..#..........#..............#.....#......#....#.#.#...#.#.###.......##...
..##.....#..#...#.#...#.#....#...#...#..#...#..........##..........#.#.#..###..........#.#...##.....
.....##.........#....##..#....#.......#...#........#..#....#.#....#...#.##.........#......#..#......
............#..#.....###..........#........##........###......#.........#.#..........G...#..........
......##...#...#.......#......#.#....##......#.#..................#..##...............#.#....#.....#
...####....#....#.#....#.#..#...#.##.#.....#..##..#..#..............##..#..#....#.###.##.#..#...##..
.....#........#.#..#...##....#...#........#..#...........#..#........##.##...........#...#.#........
.......#.......#.#.....#...#.#..#.........#....##........#..#....#.....#..#........#.#............#.
#..##.#......#.#......##...#.#....#..#.#.##.....#.#.#......##...#...#..........##.....#..#...#....#.
.#...................#.....#.#...#......#.#..........#..#...............#...#............#.#......#.
..#.......#.#........#..........#.....#..#..#....#....##...#......###......................#........
.......#.##..#...#.#..#.....#...#.#..............................#........#.#.##......#.#.....##.#..
..#.........#.......####......#.##.................................#.....##...............#...#..#..
...........#......#.......#.........#......#........#..#............#....#.........#..............#.
#...#....####.###...........#.........##..#.#...............#.#...#...........##..#..#.....##.#..#..
.#....#.....##...#..#..##....#..#.#..............#..#...#............#............#...#.#.#.#.....##
.#.....#..#......#..#...##..#...##.....#.#.....#.............#..#....#.#.....#...#.#.......#..#..#..
...........#..##........#..##.#.##.....#.#........#....##...........##....###..#.##.........#..#....
#......##..#..........#.....................#........##..#.#.....#....#..####...#.....#.#..#......#.
......####......#........##.......#....#.#.#......#.#.##.#.#..#..#......#......#.##.#....#.#.....##.
##.......#..#.....##.....#....#...#.##....#.#...#...#.#......#...#..#......#...#..##..........#..###
#...##...#....#.#..#.#..#..#..#.........#..#.#..#...........##...#........#..#..........#...#.......
.#......#..#.#...#..#.#.#...#.##....#..##..###..#@..#.#.#..........#..#....#.....#.#..#....#.....#..
...#..#..........#............#...#..#...#....#.....#...........#.#....#..##.....................##.
........#....#..#.#...#...#.....#....#..........#.#.....#.......#.....##.....##......#.##......#.#.#
.#........#.#...........#............#...#.##.....#.#.....####...........#.....#...........#......##
.......#.#........#...##...........#.....#..#.#..#..#.#.#....#..........#.#........#.#.####....#.#.#
....#.......#........##...#..##..............###.#....###.......................#...............#...
.....#..........#..........#..#.....#.####......#...#.....##................#............##...#.....
...##...##.#........##........#....#.#......#.##...##......#.#....#.#......#...#.#...#..........##..
.........#.....#.....#..#...#.........#.......#.........#...................#......#.....#.#........
................#.#..#.......####........#...##....................#........#.......##.##..#..#...##
.....#...#.#.#....##.....#...................#.#.S............#..#.#........#....#.#......#.#..#.#..
......##.........#.#....................#.#....##........#..##.....#...#...#....##.#.#........#.##..
#......##...........#......#.........##.........#..#.....#.#.#...##...#.....#..#..........#.##....#.
...#......##....#.....#.#..##.#.#...#......................##..###.....#.##...#...........#.......#.
...#.#.......#..........#.#...#.#....#...........#...#.#..#.....#.......#...........#.....##.....#..
..#...#..........#.....#.........................#..#........#...#........#....#.#..#......#.####.#.
#..#.#....#........##.#....#.#..#..#.....#.......###.#.............#.....#.............##..#.#..###.
....#......#.......................#.#....#...........#....#....###.......#...#.#...#.#........#..#.
#.#....#..#....#.#.......##.#..#.#.....#........#....#.#.###...........###..#.......................
.....#.#...#.......#..#.#.#...#...#........#...#..#..#.................#....#..##..#...##........#..
..#...........##.#.#...#..#.......#....##..#...#..#..#.#.......#.....#..#...#....##....#......##....
.#..........#..............#.....#.#...........##.#...........##....#.#.#.#..........#.##......#....
........#.###..#......###.....#.......#.............#....#...#..#.....##.........#.....#.#..#.......
.......#..................#.#..#....#........#.#...........#.....###..........#.......#...#.#.#...#.
#.....#...#.#.##.#....#...#....#..##......#.....#.....#.#...#........#.##..#.....#........#.#.#...#.
#.......#.....#..#......#........##....##.#.#.....#..#.#..............#.......#.........#.##....#...
.#......#............##..#........#...#....#...........#..#.#....#............#....##.........#.#...
..........#..##....#...............#...#..........#...............#..#......#.............#..#.#..##
