100 100
..##.....#.#......................#....##.........#......#..................##.........##..#........
....##...#..#...#.....#...............................##....##..............#.#......#....#.#.......
...#...##.........#.....................#..........#...................####...............#...#.#...
................#.####..#.......#........#.............##........#........#.......#....##.#....#..##
...#...#....##.#.##.....##........#..#........#.#..........#....#.#.##..#....#.....#...........#....
..###...##........#.#..#...#.....#..##.....#...##..###...#.##...#..#..#.#...#......#................
.....#..#..#.###..#.#....#....#....##..............#...........#..#...........#....#.#....#...#.....
..#..............#...##.......#.........###.......#..........###.....#..#..#.#....#.....#...#..##...
....##........#....#....##.#....#S##.....#.....#..##...............................#.##.....#......#
....##..#...##.....#......#............#...........#....###.....##..@.#....#......#....#.##.@#...##.
............#...#....#.##.##.........#.#.#....#.#.#..##.......#..##.#.......##.#.#.#...#.......##...
..#.....#.#..#..##......#.#.##.#....................#..#.....#.#.##..#.......#.#..........#..##.....
....#..........#....#...#.....................#...#....#.....#...#.......#..##.#...........#.####..#
#.......#.....#.......#.....#......#.#.#.##..................#..#.#..#..#.##.........#...#........##
#...#.#...#......#..#...#.................#..........#....#..#......##.#.....##....#.......##.#.....
#....#..#.##..#.#.......##.......#.#....#......#..#...#.#..#..#.#......#.......#.#..#...............
.#...#.....................#.#.......#..#...@...#.....##.......#.#..........##..#.##..............#.
#...#..........#.....#..###.#.#.......##.....#..#.#.....#.#.#..........#..#...#...........#.#.....##
.#.............#...##.#........#....#.......##.....#............#......#.............#.......#.#.#..
..#....#.......#...#.....#..#..#..##...#.........#......#..#....#......#.##.....#.#...#.......#.....
#.....#............##..#..........##..#.#...#...##..#.....#..#..#....#...#.#...#...#......#....#.#..
.#.....#...##.#.##..##.....#.....#..................#..........................##...#.#...##.##.#...
.......#...#..#...#......#.#.#............#.......#.....#...............###...#.....#...#..#.#....##
....##.......#......#...#..............##.#.#.#........#..#....#..#...#...#.....#...#...#...#.#..#..
...#..#..#..........#..#....###.........###..#......#..#.........#....#..##.....#.........#......#..
................##....#.....#.........#.#.........#........##.........#....#.......#.#..#.....##....
...#.................##...#.....#.......................###...#.#........##....##...#..#....#....#..
#.#...............#.......#..##..##...#..#.#............................#.......................##..
.......#.........#.##..........#.#...#....#####....##...###........#........#.....#.#......#.....#..
#.#.#...#....................#....#..#....................#.#.#....#.......#...#......#.........#...
......#....#.....##.......#..#...#.......#.........#......@..........#..........#.#..#...#.###...#.#
.......#.#......#..##.................##..............#........#......#....##.....##.........#.....#
.@#....#.#.#......#.....#..#....##..#.#.#.....#....#..#.............#..##.........#.........##.....#
#.....#......#.#......#####...#.#.#.....##......#...........................#......##.....##..#...#.
#.##....#.......#.....##.....##...........#..#.#..#..##.###.....###..#...#..#.#...#......#........#.
...#...#...........#......##.......#.............#..#..............#..............###...#......#..#.
....#....#......#..#..#..##...##.#...#.......#..#...#..#...#..#.#.#.#...........###.........#.......
..#.............#........#..#.....#..##...#.#.#..#............##...#....#.....###...#..#...#.#.#....
#.....#..#.#.#............#..##.......#...........#.#...#.........#..#..............#...............
...#.#....#..##..#.#.....#...##.....##.........#..........#.....@...#.#..#..#.......#.#.....#.......
#...............#..#.........#............#....#....##.#...#.#.#.#.#..........#............##.......
##...#....#.##.#..##....##...........#.#.#...###.........#..#.#..##.............#....#...##....##.##
.#...#.........#..#....####......#.#.##...#....#.#.#...............#.#......##...##........##..####.
......#........##..........#..........##.....#.#..#...........#..#.#.....##................#.......#
...................#.....#..#.............#........#.#.........##.....#....#.....####.#.#....#..#...
.....####.......#..........#....#.##.#......##........#...#..........#......#..#.#.#...##.#.##.#....
#......##.##..#......##.......#......#.......##..###.......##.#.......#..@.........#..........#....#
..#.#.#.#...#.......#.#.......#.#.....###..#...#.....#...#..........#.......#...#..#..##...##..##...
....#...........#..##.#..#......#.#..#.##............#.#.........##.#....#..#.#........#....#.......
........#..##.......##........#...#............#........#......#...........##...#.........####......
......#.#.#..#..........#.......#.....#.................#..................#..............##..#.....
...##........#......#...#.....#.##..............#.......#.#..............#......#.....#.#.....#...#.
...#.##................#.@#.##.#..#.#..#......#.....##.#..#......#.......#............##..........#.
.......#.....#...#...##........#...............#....#.....#.....#..................#.....##......#..
.....##...#.......#.................#.....#..............#.#...#........##.#..........#.............
..##......#..#.....##.#..........#..#......##...........@..#....#........##....#..........##......#.
#......#........#.#.....#..........#..#........@.##.......##.....#...#......#.#........##....#....#.
.#.#.....#.##.......#.#...............#.#..##..#...##..........#...#..........#....##..##..#..#...##
##......#...#......#...#....#...........##......#..#........#.......#..#.#..#..........#...#....##.#
#.#.#...#....#....###..#.#.#.#...#..#.#.##....#.....#......................#.....#....#.....##......
......#....#...#........##....#....##.........#..#....#....#...........#..#.##....#.......##........
.##.#...@..##..........#....#...#.........#...#.......#...#.......#...#......#...............#......
.#..##....#.#....#.............#.........#................#..#.##..###....#....##...#.#.#..#..#..#..
.#..#...#..........#.......##.#....#....#...................##..#......#.#....#.....##.......##.##..
......#...........#....#.....#..#.#.........#........#.......##.##......##..#......@#........#...#..
##........#...............#...#.........#......#...#.##..##...#####...#...............##...#.#.#....
.......#.#.....#................#.#.........##.........#.....#.##.....#.......#......#.#...#........
......#.#............##.................#.................................#...#....#......##....##.#
......#...#......#..................#....#.#....#.....#...#...............##..........###...#.......
......#.....#....#........#......#...#.#..##....................###...##..#..........#.#..#......#..
......##..#.#..#..........#..#................#.........#.....#.............#......#...#......#.#...
..#.........#..........#..##.................##.....................#.#...#.#....#.#......#..#.#....
#.......#.#..........####............##...##...@..#...#......#..##....#...#..#..#....#..#.....#...#.
#.#..#.#...#.........##..#.#...#........#....#.........#....#...#........#.#.........##..#.....##..#
..........#..........#..##..###...........#.....#........#.....#.....#.#....##......#....#.......#.#
..............##...#.#.#.....#.....##.......#..#.#.#...#...............#..#....#.##...#............#
..##.#.##..#..#....#..##.#......##........#.#..#..............#..##.............#...#.#.........#..#
.#....##..#.###...#.............#.......#......#.......##....#....#.#........#..#...................
.......#.#..#.....###........##..##....#.....#.....#.#...............#.#......#.....#.#..#....#....#
..##....#..#............#...#...#.#.#.........##...............#..#....#..............#.....#...#..#
.###..#........#.#.#.....................#....#.........#..#.............#.#.............#.#........
..............#.#..................#.#..........#.#..##...##.#..#....#..##......#..#....#....###....
...#........#.#.#.#.#.....#.......#...#..#.#.#....##...........##.##.......##.#...#..#...........#..
...#...........#...........#.....#.###.......#..#..................#.......#........#.#..##......#..
....#.....#........#....#####.###.................##.................................#.......#......
.#..#..#...##............#.#..#.#......##....#......#..............#..#.##.#....##..#.#....#.#.#...#
#...#.....#.....................##...#@......##.#.....#...........##..................#.............
#...#....#.........##.#.....#....#..#....##..#.#.......##................#.#.#.....#...#..#.##...##.
.....#......@..#........#....#..##.@#..............#........##.........#...........#..#.........#...
......#.#.#.#..#.....#.#.##.###.....#..........####.###.........#.#.....#..#....#.......#..........@
....#.#....#.....#..#...#....##..##....#.#...##........####............#.#.#...#...G.#...#......#...
....#.#...#........#....#...##..............#...#.......#..........#.#....................#.##.#.#.#
....##......##.......#.....##.#.......#...#.#.........@.............#...#..##....#.......#..#.#..#..
.##.........#.#.......#....#.##.....#............#............#.#....#....#..................##.....
#.#....#....#..........#..#...##.....#.................#......#......#...##..#........#.............
.....##.#......#.....#..........#......#..#...#.#...#..##......#.....#..#.##...#..........#......#..
.....#..####...........#...#....##..#....#.#.#.....#......................#.....##......#.....#....#
.#....####...#...#..#...#.#.........................#....##....#...................#...............#
.#...#.##.....##.....#...#.............##..#...#....#..#.#.#...#.......#..#.....#.........##......#.
...#.........#...#..#.........#...#.......#.............#.#.......#.........#.........#.....####....
